i 850 i 850 i 850 i 850 i 850 i 850 i 850 i 850 i 850 i 850 i 850 i 850
s 1000 h 1000 s 1000 h 1000 s 1000 h 1000 s 1000 h 1000 s 1000 h 1000
h 1000 h 1000 h 1000 h 1000 i 1000 i 1000 i 1000 i 1000 i 1000 i 1000
h 1000 i 1000 i 1000 i 1000 i 1000 i 1000 i 1000 i 1000 i 1000 i 1000
i 1000 i 1000 i 1000 i 1000 i 1000 i 1000 i 1000 i 1000 i 1000 i 1000
i 1000 i 1000 i 1000 i 1000 i 1000 i 1000 i 1000 i 1000 i 1000 i 1000
i 1000 i 1000 i 1000 i 1000 i 1000 i 1000 i 1000 i 1000 i 1000 i 1000
i 1000 i 1000 i 1000 i 1000 i 1000 i 1000 i 1000 i 1000 i 1000 i 1000
i 1000 i 1000 i 1000 i 1000 i 1000 i 1000 i 1000 i 1000 i 1000 i 1000
i 1000 i 1000 i 1000 i 1000 i 1000 i 1000 i 1000 i 1000 i 1000 i 1000