^^^^^^^^^^^^^^^^
0--------^^^^^^^
^^#^#^##------^^
^------##^^^#-^^
^-^#^#--------^^
^-#^#^^^^###^^^^
^-------------^^
^^^^^###^^^^^-^^
^^#-------#^#-^^
^^#-#^#^#-^^^-^^
^^#-#^^^#-----^^
^^#9#^^^^^^^^^^^