^^^^^^^^#######^
^^^^^^^-------9^
^^^^^^^-#######^
^^^^^^#-^^^^^^^^
^#------^^^^^^^^
^#-#^#^#^^----^^
^#-^#^^^##-#^-^^
^#---------^#-^^
^^^#^#^^^^#^#-^^
^#^^^^^##^^#^-^^
0-------------^^
^^^^^^^^^^^^^^^^