################
0-##############
#-------------##
#############-##
#-------------##
#-##############
#------------###
############-###
###-------##-###
###-#####-##-###
###-#####----###
###9############
