^^^^^^^^^^^^^^^^
0--------^^^^^^^
^#######------^^
^------######-^^
^-^^^^--------^^
^-^^^^########^^
^-------------^^
^^###########-^^
^^#-------#^#-^^
^^#-#####-###-^^
^^#-#^^^#-----^^
^^#9#^^^######^^
