##0###9##8###1##
##-###-##-###-##
##-###-##-###-##
##-###-##-###-##
##-###-##-###-##
##-###-##-###-##
##-###-##-###-##
##-###-##-###-##
##-###-##-###-##
##-###-##-###-##
##-----##-----##
################
