##########^^^^^^
0--------######^
########------#^
#------######-#^
#-####--------#^
#-#############^
#-------------#^
#############-#^
^^#-------#^#-#^
^^#-#####-###-#^
^^#-#^^^#-----#^
^^#9#^^^#######^