################
#######--------9
#######-########
#######-########
##------########
##-#######----##
##-#######-##-##
##---------##-##
#############-##
#############-##
0-------------##
################
