^^^^^^^^^#^^##^^
^^^^^^^-------9^
^^^^^^^-#^^#^^^^
^^^^^^#-^##^##^^
^#------^^^^^^^^
^#-#^#^#^^----^^
^#-^#^^^##-#^-^^
^#---------^#-^^
^^^#^#^^^^#^#-^^
^#^^^^^##^^#^-^^
0-------------^^
^^^^^^^^^^^^^^^^