^^^^^^^########^
1-------------9^
^^^^^^^-#######^
#######-#^^^^^^^
##------#######^
##-#######----#^
##-#######-##-#^
##---------##-#^
#############-#^
#############-#^
0-------------#^
###############^