################
0-##############
#-------------##
#############-##
#-------------##
#-##############
#-------------##
#############-##
###-------###-##
###-#####-###-##
###-#####-----##
###9############