^^^^^^^^^^^^^^^^
0--------^^^^^^^
^^^^^^##------^^
^------##^^^#-^^
^-^#^#--------^^
^-#^#^^^^^^^^^^^
^-------------^^
^^########^^^-^^
^^#-------#^#-^^
^^#-#####-^^^-^^
^^#-#^^^#-----^^
^^#9#^^^######^^
