^^^^^^^########^
^^^^^^^-------9^
^^^^^^^-#######^
^^^^^^#-^^^^^^^^
^#------^^^^^^^^
^#-#^#^#^^----^^
^#-^#^^^##-#^-^^
^#---------^#-^^
^^^#^#^^^^#^#-^^
^#^^^^^^^^^#^-^^
0-------------^^
^^^^^^^^^^^^^^^^