###############
0-#############
#-------------#
#############-#
#-------------#
#-#############
#------------##
############-##
###-------##-##
###-#####-##-##
###-#####----##
###9###########
